NO textures/NO.xpm
SO textures/SO.xpm
WE textures/WE.xpm
EA textures/EA.xpm

F 30,15,10
C 20,30,90

1111111
1010101   
10N0101
1000101
1111111